16 16
^#     # #     #
 # ### # # ###  
     # #     ## 
###### ##### #  
       #   # # #
 ### ### # # # #
   #     # # # #
 ######### # # #
 #         # # #
 # ### ##### # #
 #   #  #    #  
 # ###### ##### 
## #   ##   #   
 # # #    # # ##
 # ######## #   
            ###$

